List of newspapers in Canada

==Daily newspapers==
==Local weeklies==
===Alberta===
* Airdrie – Airdrie Echo
* Athabasca – Athabasca Advocate
* Barrhead – Barrhead Leader
* Bashaw – Bashaw Star
* Bassano – Bassano Times
* Beaumont – Beaumont News
* Beaverlodge – Beaverlodge Advertiser
* Bonnyville – Bonnyville Nouvelle
* Bow Island – Bow Island Commentator
* Bow Valley – Bow Valley Crag & Canyon
* Bowden – The Voice of Bowden
* Brooks – Brooks & County Chronicle, Brooks Bulletin
* Calmar – Calmar Community Voice
* Camrose – Camrose Booster
* Canmore – Rocky Mountain Outlook
* Cardston – The Star
* Carstairs – Carstairs Courier
* Castor – Castor Advance
* Chestermere – Chestermere Anchor
* Claresholm – Claresholm Local Presz
* Coaldale – Coaldale Sunny South News
* Cochrane – Cochrane Times, Cochrane Eagle
* Cold Lake – Cold Lake Sun, Cold Lake Courier
* Consort – Consort Enterprise
* Coronation – Coronation Review
* Crossfield/Irricana – Five Village Weekly
* Crowsnest Pass – Crowsnest Pass Herald
* Devon – Devon Dispatch News
* Didsbury – Didsbury Review
* Drayton Valley – Drayton Valley Western Review
* Drumheller – Drumheller Mail, inSide Drumheller
* Eckville – Eckville Echo
* Edson – Weekly Anchor
* Elk Point – Elk Point Review
* Fairview – Fairview Post
* Fort McMurray – Fort McMurray Today
* Falher – Smoky River Express
* Fort Macleod – Fort Macleod Gazette
* Fort Saskatchewan – Fort Saskatchewan Record, Sturgeon Creek Post, Fort Saskatchewan This Week
* Fox Creek – Fox Creek Times
* Grande Cache – Grande Cache Mountaineer
* Grimshaw – Mile Zero News
* Hanna – Hanna Herald
* High Level – Echo Pioneer
* High Prairie – South Peace News
* High River – High River Times
* Hythe – Hythe Headliner
* Innisfail – Innisfail Province, Innisfail Booster
* Jasper – The Fitzhugh
*Lac La Biche – Lac La Biche Post
* Lamont – Lifestyle Regional News
* Leduc – Leduc Representative, Leduc & County This Week, Leduc-Wetaskiwin Pipestone Flyer
* Leslieville – The Western Star
* Lethbridge – Lethbridge Sun Times, Cover Story, Lethbridge Journal
* Lloydminster – Lloydminster Meridian Booster, Lloydminster Source
* Magrath – Westwinds Community News
* Manning – Manning Banner Post
* Mayerthorpe – Mayerthorpe Freelancer
* Millet – Leduc-Wetaskiwin Pipestone Flyer
* Morinville – Morinville Free Press, The Morinville News
* Nanton – Nanton News
* Okotoks – Okotoks Western Wheel
* Olds – Olds Albertan, Olds Gazette, Mountain View County News
* Onoway – Lac Ste. Anne Bulletin, Onoway Community Voice
* Oyen – Oyen Echo
* Parkland County – Tri Area News
* Peace River – Peace River Record-Gazette
* Pincher Creek – Pincher Creek Echo
* Ponoka – Ponoka News, Ponoka Herald
* Provost – Provost News
* Red Deer – Central Alberta Advisor, Red Deer Advocate
* Redcliff – 40-Mile County Commentator
* Redwater – Redwater Review, Redwater Tribune
* Rimbey – Rimbey Review
* Rocky Mountain House – Rocky Mountain House Mountaineer
* Rocky View County – Rocky View Weekly
* Rycroft – Rycroft Central Peace Signal
* St. Albert – Saint Albert Gazette, Saint City News
* St. Michael – Elk Island Triangle
* St. Paul – St. Paul Journal
* Sedgewick – Sedgewick Community Press
* Sherwood Park – urltoken Bugle Publications, Sherwood Park News, Sherwood Park This Week, Strathcona County This Week
* Slave Lake – Lakeside Leader, Slave Lake Scope
* Smoky Lake – Smoky Lake Signal
* Spruce Grove – Spruce Grove Examiner, Tri Area News
* Standoff – Blood Tribe News
* Stettler – Stettler Independent
* Stony Plain – Stony Plain Reporter, Spruce Grove/Stony Plain This Week, Tri Area News
* Sundre – Sundre Round-Up
* Swan Hills – The Grizzly Gazette
* Sylvan Lake – Sylvan Lake News
* Taber – Taber Times
* Three Hills – Three Hills Capital
* Tofield – Tofield Mercury
* Two Hills – Two Hills and County Chronicle, Two Hills Town & Country
* Valleyview – The Valleyview Town & Country
* Vauxhall – Vauxhall Advance
* Vegreville – Vegreville News and Advertiser
* Vermilion – Vermilion Standard, Vermilion Voice
* Veteran – Veteran Eagle
* Viking – Viking Weekly Review
* Vulcan – Vulcan Advocate
* Wabamun – Wabamun Community Voice
* Wainwright – Wainwright Review, Wainwright Star Chronicle, Wainwright Edge
* Westlock – Westlock News
* Wetaskiwin – Wetaskiwin Times Advertiser, Leduc-Wetaskiwin Pipestone Flyer
* Whitecourt – Whitecourt Press, Whitecourt Star
===British Columbia===
* Abbotsford – Abbotsford News, Abbotsford Times
* Agassiz – Agassiz Harrison Observer
* Aldergrove – Aldergrove Star
* Armstrong, British Columbia – Okanagan Advertiser
* Ashcroft/Cache Creek – Ashcroft-Cache Creek Journal
* Barriere – North Thompson Star/Journal
* Bowen Island – Undercurrent
* Burnaby – Burnaby Now
* Burns Lake – Lake District News
* Campbell River – Campbell River Mirror
* Chase/Salmon Arm – Shuswap Market News
* Chilliwack – Chilliwack Progress
* Clearwater – North Thompson Times
* Coquitlam – Coquitlam Now
* Courtenay/Comox – Comox Valley Echo, Comox Valley Record
* Cranbrook – East Kootenay Weekly, Kootenay News Advertiser
* Creston – Creston Valley Advance
* Dawson Creek – Alaska Highway News, The Mirror
* Delta – Delta Optimist, North Delta Sentinel
* Denman Island/Hornby Island – Hornby-Denman Island Grapevine
* Duncan/Cowichan Valley – Cowichan Valley Citizen
* Esquimalt – Esquimalt News
* Fernie – Fernie Free Press
* Fort Nelson – Fort Nelson News
* Fort St. James/Valemount – Caledonia Courier
* Fort. St. John – North Peace Express, The Northerner
* Gabriola Island – Gabriola Sounder
* Gibsons – Coast Independent
* Gold River – The Record
* Golden – Golden Star
* Grand Forks – Grand Forks Gazette
* Greenwood – Boundary Creek Times
* Gulf Islands – Island Tides, Gulf Islands Driftwood
* Hagensborg – Coast Mountain News
* Haida Gwaii – Queen Charlotte Islands Observer
* Hope – Hope Standard
* Houston – Houston Today
* Invermere – The Valley Echo
* Kamloops – Kamloops This Week
* Kelowna – Kelowna Capital News
* Keremeos – Gazette of the Similkameen, Keremeos Review
* Kitimat – Northern Sentinel
* Ladysmith – Ladysmith Chronicle
* Lake Country – Lake Country News, The View in Lake Country
* Lake Cowichan – Lake Cowichan Gazette
* Langley – Langley Advance, Langley Times
* Lillooet – Lillooet-Bridge River News
* Lumby – Lumby Valley Times
* Mackenzie – The Times
* Maple Ridge/Pitt Meadows – Maple Ridge-Pitt Meadows News, Maple Ridge-Pitt Meadows Times
* Merritt – Merrit Herald, Merritt News
* Mission – Mission City Record
* Nakusp – Arrow Lakes News
* Nelson – Kootenay Weekly Express
* New Westminster – New Westminster Record
* North Vancouver – North Shore News
* Oak Bay – Oak Bay News
* Okanagan Falls – Okanagan Falls Review
* Oliver – Oliver Chronicle
* 100 Mile House – 100 Mile House Free Press
* Osoyoos – Osoyoos Times, Desert Connections
* Parksville/Qualicum Beach – The Morning Sun, The Parksville Qualicum News
* Peachland – Peachland View
* Penticton – Penticton Herald
* Port Hardy – Mid Coast Beacon, North Island Gazette
* Powell River – Powell River Peak
* Prince George – Prince George This Week,The Prince George Citizen
* Prince Rupert – Northwest Weekly/Prince Rupert This Week
* Princeton – Similkameen Spotlight
* Quesnel – Quesnel Cariboo Observer
* Revelstoke – Revelstoke Times-Review
* Richmond – Richmond News
* Rossland – Rossland Telegraph
* Saanich – Saanich News
* Salmon Arm – Lakeshore News, Salmon Arm Observer
* Sechelt – Coast Reporter, Kahtou
* Sidney – Peninsula News Review
* Smithers – Interior News
* Sooke – Sooke News Mirror
* Sparwood – Elk Valley Miner, Mountainview Weekly
* Squamish – Squamish Chief
* Sumas/Matsqui (Abbotsford) – Sumas & Matsqui Times
* Summerland – Summerland Review, Summerland/Peachland Bulletin
* Surrey – Surrey Now, Indo-Canadian Voice
* Terrace – Terrace Standard, Terrace Times
* Tumbler Ridge – Tumbler Ridge Observer
* Ucluelet – The Westerly News
* Valemount – The Rocky Mountain Goat, The Valley Sentinel
* Vancouver – The Georgia Straight
* Vanderhoof – Vanderhoof Omineca Express
* Vernon – The Morning Star
* Victoria – Goldstream News Gazette, Victoria News
* Westbank – Westside Weekly
* Whistler – Whistler Question, Whistler Pique
* Williams Lake – Cariboo Advisor, Williams Lake Tribune
* Zeballos – Zeballos Privateer
===Manitoba===
* Baldur – The Gazette
* Beausejour – The Clipper Weekly
* Boissevain – The Recorder
* Brandon – Community News
* Brandon – Westman Journal
* Carberry – Carberry News Express
* Dauphin – Dauphin Herald
* Flin Flon – The Reminder
* Gimli – The Express Weekly News
* Minnedosa – The Minnedosa Tribune
* Neepawa – Neepawa Banner, Neepawa Press
* Portage la Prairie – Central Plains Herald-Leader
* Powerview-Pine Falls – Winnipeg River Echo
* Richer – Dawson Trail Dispatch
* Rivers – Rivers Banner
* Russell – The Russell Banner
* St. Boniface – La Liberté
* Selkirk – The Selkirk Record
* Shoal Lake – Crossroads This Week
* Steinbach – Carillon News
* Stonewall – The Stonewall Teulon Tribune
* Swan River – The Star and Times
* The Pas – The Opasquia Times
* Thompson – Nickel Belt News, Thompson Citizen
* Virden – Virden Empire-Advance
* Winnipeg – The Grassroots News, The Winkler Morden Voice
* Winnipeg – Worldwide News, urltoken Current Affairs & History of National Events of All Countrie
===New Brunswick===
* Bathurst – L'Étoile Chaleur, Northern Light
* Bouctouche – L'Étoile Kent
* Campbellton – La Voix du Restigouche, The Tribune
* Dieppe – L'Étoile Dieppe
* Grand Bay-Westfield – The River Valley News
* Grand Falls – The Victoria Star
* Miramichi – Miramichi Leader
* Oromocto – Post Gazette
* St. Stephen – St. Croix Courier
* Shediac – L'Étoile Shediac
* Sussex – Kings County Record
* Woodstock – Bugle-Observer
===Newfoundland and Labrador===
* St. John's – The Express, Le Gaboteur
===Northwest Territories===
* Hay River – The Hub
* Inuvik – Inuvik Drum
* Yellowknife – Yellowknifer, News/North
===Nova Scotia===
* Annapolis Royal – The Spectator
* Baddeck – The Victoria Standard
* Bass River – The Shoreline Journal
* Bedford – Bedford-Sackville Observer
* Bridgewater – The Bulletin
* Chester – The Chester Times
* Dartmouth – Dartmouth Tribune
* Digby – The Digby Courier
* Greenwood – The Aurora
* Guysborough – Guysborough Journal
* Halifax – Halifax Citizen
* Inverness – The Inverness Oran
*Liverpool – The Advance
* Lunenburg – The Progress Enterprise
* Middleton – The Annapolis County Spectator
* Parrsboro – The Citizen-Record
* Pictou – The Advocate
* Port Hawkesbury – The Reporter
* Shelburne – The Coast Guard
* Springhill – The Record
* Tatamagouche – The Light
* Windsor – The Hants Journal
* Yarmouth – The Sou'Wester, Nova News Now
===Nunavut===
* Iqaluit – News/North, Nunatsiaq News
* Rankin Inlet – Kivalliq News
===Ontario===
* Ajax – Ajax News Advertiser
* Alexandria – Glengarry News
* Alliston – Alliston Herald
* Almonte – Almonte Gazette
* Alvinston – Transcript and Free Press
*Amherstburg – River Town Times
* Arnprior – Arnprior Chronicle-Guide, Arnprior Weekender News
* Arthur – Arthur Enterprise News
* Atikokan – Atikokan Progress
* Aurora – Aurora Banner, Auroran
* Aylmer – Aylmer Express
* Ayr – Ayr News
* Bancroft – Bancroft This Week, Bancroft Times and North Hastings Advertiser
* Barrie – Barrie Advance
* Barry's Bay – The Valley Gazette 
* Beamsville – Lincoln Post Express
* Beaverton – Brock Citizen
* Beeton – Beeton Record Sentinel
* Belle River – North Essex News
* Bracebridge – Bracebridge Examiner, The Muskokan, Muskoka Sun, Weekender
* Brampton – Brampton Guardian, South Asian Focus
* Brighton – Brighton Gazette, Brighton Independent
* Burk's Falls – Almaguin News
* Burlington – Burlington Post
* Caledon – Caledon Citizen, Caledon Enterprise, The Caledon Underground
* Caledonia – Grand River Sachem
* Cambridge – Cambridge Times
* CFB Trenton – Contact
* Carleton Place – Carleton Place Almonte Canadian Gazette
* Chatham – Chatham This Week, Today's Farmer
* Clarington – Clarington This Week, The Orono Weekly Times
* Clinton – The Clinton News-Record
* Cobourg – Northumberland News
* Cochrane – Cochrane Times-Post
* Colborne – Colborne Chronicle
* Collingwood – Collingwood Connection
* Cornwall – Seaway News, The Seeker
*Deep River – North Renfrew Times
* Delhi – The Delhi News-Record
* Dresden – Leader Spirit
* Durham – Durham Chronicle
* Elliot Lake – Elliot Lake Standard
* Elmira – Woolwich Observer
* Erin – Erin Advocate
* Espanola – Mid-North Monitor
* Essex – Essex Voice
* Etobicoke – Etobicoke Guardian
* Exeter – Exeter Times-Advocate
* Fergus – Fergus Elora News Express, Wellington Advertiser
* Fort Frances – Fort Frances Times, Fort Frances Times
* Gananoque – Gananoque Reporter
* Georgina – Georgina Advocate
* Glencoe – Transcript and Free Press
* Goderich – Goderich Signal Star
* Grand Bend – Lakeshore Advance
* Gravenhurst – Gravenhurst Banner
* Grimsby – Grimsby Lincoln Independent
* Guelph – Guelph Tribune
* Haliburton – Haliburton Echo, The Highlander
* Halton Hills – Independent and Free Press
* Hamilton – Ancaster News, Dundas Star News, Flamborough Review, Glanbrook Gazette, Hamilton Mountain News, Stoney Creek News
* Hanover – Hanover Post
* Huntsville – Huntsville Forester
* Ignace – Driftwood
* Innisfil – Innisfil Scope, Innisfil Journal
* Kawartha Lakes – Kawartha Lakes This Week
* Kemptville – Kemptville Advance
* Kenora – Kenora Daily Miner and News
* Kincardine – Kincardine News
* King – King Sentinel, King Connection
* Kingston – Kingston This Week, Frontenac This Week, urltoken Kingstonist, urltoken YGK News
* Kitchener – Kitchener Post
* London – The Londoner, London Community News
* Lucknow – Lucknow Sentinel
*Manitoulin - Expositor
*Markdale – Markdale Standard
* Markham – Markham Economist and Sun
* Midland – Midland Penetanguishene Mirror
* Milton – Milton Canadian Champion
* Minden – Minden Times
* Minto – Minto Express
* Mississauga – Mississauga News, Mississauga This Week, The Booster
* Mitchell – Mitchell Advocate
* Mount Forest – Mount Forest Confederate
* New Hamburg – New Hamburg Independent
* Newmarket – Newmarket Era
*North Huron - North Huron Citizen
* Oakville – Oakville Beaver
* Orangeville – Orangeville Banner
* Orillia – Orillia Today
* Oshawa – Oshawa This Week, Oshawa Express
*Oshweken – Turtle Island News
* Ottawa – Nepean This Week, La Nouvelle Étudiant / L'Express Étudiant, Manotick News, UpFront Ottawa
* Parry Sound – Lifestyles This Week, Parry Sound Beacon Star, Parry Sound North Star
* Pembroke – Pembroke News
* Perth – Perth Courier
* Petawawa – Petawawa News
* Peterborough – Peterborough This Week
* Pickering – Pickering News Advertiser
* Port Perry – Scugog Standard, Port Perry Star
* Prince Edward County – Picton County Weekly News, Prince Edward Free Press
* Renfrew – Renfrew Mercury
* Richmond Hill – Richmond Hill Liberal
* Sarnia – Sarnia This Week
* Saugeen Shores – Shoreline Beacon
* Sault Ste. Marie – Sault This Week
* Seaforth – Seaforth Huron Expositor
* Smiths Falls – Smiths Falls Record News
* Springwater – Springwater News
* Stayner – Stayner Sun
* Stirling – Stirling Community Press
* Stouffville – Stouffville Sun-Tribune
* Strathroy – Strathroy Age Dispatch
* Sudbury – Northern Life, Le Voyageur
* Tavistock, Ontario – Tavistock Gazette
* Temiskaming Shores – Temiskaming Speaker
* Thornbury – Thornbury Courier-Herald
* Thornhill – Thornhill Liberal
* Thunder Bay – Thunder Bay Source
* Tillsonburg – Tillsonburg News
* Timmins – Timmins Times, L'Express de Timmins
* Toronto – L'Express (Toronto), Beach and South Riverdale Mirror, Bloor West Villager, City Centre Mirror, East York Mirror, Etobicoke Guardian, The Orono Weekly Times, NOW Magazine, North York Mirror, Parkdale Liberty Villager, Scarborough Mirror, "GTA Weekly", York Commonwealth, York Guardian.
* Tottenham – Tottenham Times
* Trent Hills – Trent Hills Independent
* Trenton – Trenton Trentonian
* Uxbridge – Uxbridge Times Journal, Uxbridge Cosmos, Uxbridge Standard
* Vankleek Hill, Ontario – The Review
* Vaughan – Vaughan Citizen
* Walkerton – Walkerton Herald-Times
* Wallaceburg – Wallaceburg Courier Press, Wallaceburg News
* Wasaga Beach – Wasaga Sun
* Waterloo – Waterloo Chronicle
* West Lorne – West Lorne Chronicle
* Whitby – Whitby This Week
* Wiarton – Wiarton Echo
* Wingham – Wingham Advance Times
* Woodbridge – Woodbridge Advertiser
* Woodstock, Ontario – Woodstock Sentinel-Review
===Prince Edward Island===
* Alberton – The West Prince Graphic
* Montague – The Eastern Graphic
===Quebec===
* Alma – Journal le Lac St-Jean
* Amos – Le Citoyen de l'Harricana, Abitibi Express
* Amqui – L'Avant-Poste
* Aylmer – Bulletin d'Aylmer, West Quebec Post
* Baie-Comeau – Plein Jour de Baie-Comeau
* Beauport – Journal Beauport Express
* Beaupré – Journal L'Autre Voix
* Boucherville – Réseau Montérégie, La Relève
* Charlesbourg – Journal Charlesbourg Express
* Châteauguay – Vision
* Chibougamau – La Sentinelle de Chibougamau, Le Jamésien
* Coaticook – Le Progrès de Coaticook
* Cowansville – Le Guide
* Dolbeau-Mistassini – Journal Nouvelles Hebdo
* Drummondville – L'Express
* Eeyou Istchee Territory – The Nation
* Farnham – L'Avenir et des Rivières
* Fort-Coulonge – Pontiac Journal du Pontiac
* Gaspé – Gaspésie Nouvelles, L'Aviron, The Gaspé Spec
* Gatineau – Info07, La Revue, Le Bulletin, L'Étudiant Outaouais
* Granby – Granby Express
* Hudson – Gazette Vaudreuil-Soulanges
* Huntingdon – The Gleaner/La Source
* Joliette – L'Action
* Kahnawake – The Eastern Door
* Knowlton – The Brome County News
* La Sarre – Le Citoyen de l'Abitibi-Ouest
* La Tuque – L'Écho de La Tuque
* Lac-Etchemin – La Voix du Sud
* Lac-Mégantic – L'Écho de Frontenac
* Lachute – Main Street
* Laurier-Station – Le Peuple Lotbinière
* Laval – Courrier Laval The Laval News, The North Shore News
* Lennoxville – The Townships Sun
* Lévis – Le Peuple de Lévis
* Longueuil – Le Courrier Du Sud
* Louiseville – L'Écho de Maskinongé
* Magog – Le Reflet du Lac
* Mirabel – Le Mirabel
* Mont-Joli – L'information Mont-Joli
* Mont-Tremblant – L'Information du Nord Mont-Tremblant, Laurentides Express
* Montmagny – Le Peuple de la Côte-Sud
* Montreal – Parc-Extension News, Nouvelles Saint-Laurent News, Courrier Ahuntsic & Bordeaux-Cartierville, Avenir de l'est, Le Flambeau de l'Est, L'Informateur de Rivière-des-Prairies, Nouvelles Hochelaga-Maisonneuve, Cités Nouvelles, Le Messager Verdun, Progrès Villeray – Parc-Extension, Progrès Saint-Léonard, Guide Montréal-Nord, Journal de Rosemont – La Petite-Patrie, Le Plateau, La Voix Pop, Le Messager LaSalle, Le Messager Lachine & Dorval, Montréal Express, Journal de St-Michel, Le Messager Week-End, Le Magazine Île-des Soeurs, The Chronicle, The Suburban, Les Affaires, Montreal Times, Nuns' Island Magazine, Westmount Independent
* Napierville – Coup d'Oeil
* Nicolet – Le Courrier Sud
* Piedmont – Accès Laurentides
* Port-Cartier – Le Port Cartois
* Quebec City – Quebec Chronicle-Telegraph, Journal de l'habitation, Journal Le Jacques-Cartier, Québec Hebdo, Journal L'Actuel, Journal L'Appel, Journal Le Québec Express
* Repentigny – Hebdo Rive Nord
* Rimouski – Journal L'Avantage
* Rivière-Rouge – L'Information du Nord Vallée de la Rouge
* Roberval – L'Étoile du Lac
* Rouyn-Noranda – La Frontière, Le Citoyen Rouyn-Noranda
* Saguenay – Courrier du Saguenay
* Saint-André-Avellin – La Petite-Nation
* Saint-Bruno-de-Montarville – Journal les Versants
* Saint-Eustache – L'Écho de Saint-Eustache, L'Éveil et La Concorde
* Saint-Georges – L'Éclaireur Progrès, Édition Beauce
* Saint-Hubert – Rive-Sud Express
* Saint-Jean-sur-Richelieu – Le Canada Français
* Saint-Jérôme – L'Écho du Nord, Journal Le Nord
* Saint-Lin-Laurentides – L'Express Montcalm
* Saint-Sauveur – Le Journal des Pays-d'en-Haut La Vallée
* Saint-Tite – L'Hebdo Mékinac Des Chenaux
* Sainte-Agathe-des-Monts – L'Information du Nord Sainte-Agathe
* Sainte-Anne-des-Monts – Le Riverain, Point de vue Sainte-Agathe
* Sainte-Thérèse – Nord Info et Voix des Mille-Iles, Journal le Courrier
* Salaberry-de-Valleyfield – Southwest News/Le Suroit
* Sept-Îles – Le Nord-Est
* Shawinigan – L'Hebdo du St-Maurice
* Shawville – The Equity
* Sherbrooke – Le Journal de Sherbrooke, The Townships Outlet
* Terrebonne – Le Trait d'Union
* Thetford Mines – Courrier Frontenac
* Trois-Rivières – L'Hebdo Journal
* Val-d'Or – Le Citoyen de la Vallée de l'Or, L'Écho Abitibien
* Val-des-Sources – Les Actualités
* Vaudreuil-Dorion – L'Étoile, Your Local Journal
* Victoriaville – La Nouvelle Union
* Wakefield – The Low Down to Hull and Back News
===Saskatchewan===
* Assiniboia – Assiniboia Times
* Battleford/North Battleford – The Battlefords News Optimist
* Biggar – Biggar Independent
* Bredenbury/Churchbridge/Langenburg/Saltcoats – The Four-Town Journal
* Broadview – Broadview Express
* Canora – Canora Courier
* Carlyle – Carlyle Observer
* Carnduff – Carnduff Gazette Post News
* Craik – Craik Weekly News
* Creighton – The Northern Visions Gazette
* Cut Knife – Cut Knife Highway 40 Courier
* Davidson – Davidson Leader
* Esterhazy – Esterhazy Miner-Journal
* Estevan – Estevan Mercury, Southeast Trader Express
* Eston/Elrose – Eston-Elrose Press Review
* Foam Lake – Foam Lake Review
* Fort Qu'Appelle – Fort Qu'Appelle Times
* Gravelbourg – Gravelbourg Tribune
* Grenfell – Grenfell Sun
* Gull Lake – Gull Lake Advance
* Herbert – Herbert Herald
* Humboldt – Humboldt Journal
* Indian Head/Wolseley – Indian Head-Wolseley News
* Ituna – Ituna News
* Kamsack – Kamsack Times
* Kelvington – Kelvington Radio, Northeast Chronicle
* Kerrobert – Kerrobert Citizen
* Kindersley – Kindersley Clarion
* Kinistino/Birch Hills – Kinistino-Birch Hills Post-Gazette
* Kipling – Kipling Citizen
* Lanigan – Lanigan Advisor
* Leader – Leader-Post
* Lloydminster – Lloydminster Meridian Booster, Lloydminster Source
* Macklin – Macklin Mirror
* Maidstone – Maidstone Mirror
* Maple Creek – Maple Creek and Southwest Advance Times, Maple Creek News
* Meadow Lake – Meadow Lake Northern Pride
* Melfort – Melfort Journal
* Melville – Melville Advance
* Moosomin – Moosomin World-Spectator
* Naicam – Naicam News
* Nipawin – Nipawin Journal
* Norquay – Norquay North Star
* Outlook – The Outlook
* Oxbow – Oxbow Herald
* Preeceville – The Preeceville Progress
* Prince Albert – Rural Roots
* Radville – Radville Star, Deep South Star
* Regina – Regina Sun
* Rosetown – Rosetown Eagle
* Rosthern – Saskatchewan Valley News
* St. Walburg – St. Walburg & Area Gazette
* Saskatoon – Saskatoon Bridges
* Shaunavon – Shaunavon Standard
* Shellbrook – Shellbrook Chronicle
* Strasbourg – Last Mountain Times
* Swift Current – The Prairie Post, The Southwest Booster
* Tisdale – The Parkland Review, Tisdale Recorder
* Turtleford – Northwest Neighbors
* Unity – Northwest Herald
* Wadena – Wadena News
* Wakaw/Cudworth – Wakaw Recorder & Cudworth Progress
* Warman – The Country Press
* Watrous – Watrous Manitou
* Watson – East Central Connection
* Weyburn – Weyburn Review, Weyburn This Week
* Whitewood – Whitewood Herald
* Wilkie – Wilkie Press
* Wolseley – Wolseley Bulletin
* Wynyard – Advance Gazette
* Yorkton – Yorkton This Week
==Alternative weeklies==
===British Columbia===
* Vancouver – Georgia Straight
* Victoria – Monday Magazine
===Manitoba===
* Winnipeg – Uptown
===Newfoundland and Labrador===
* St. John's – The Scope
===Nova Scotia===
* Halifax – The Coast
* Annapolis Valley – The Grapevine
===Ontario===
* Hamilton – View Magazine
===Prince Edward Island===
* Charlottetown – The Buzz
===Quebec===
* Montreal – Voir
===Saskatchewan===
* Regina – Prairie Dog
==Ethnic and multicultural newspapers==
=== Pashto ===
* Toronto – Afghan Post
===Arabic===
*London, Ontario – urltoken Al Bilad, Al Falqa
*Mississauga – urltoken Al-Wattan
*Montreal – Al Akhbar , Al-Ayam Al Arabia (الايام العربية) (Arabic), Al Awsat , Al Hadath , Al Mustakbal , Al Machreq et Al-Maghreb (Arabic, French), Atlas.Mtl (French), El Mahrousa , El Masri , Founoun , Phoenicia (Arabic, French, English, Armenian), Sada al Mashrek (Arabic, French, English), Shlomeel - Salam Allah (Arabic, French, English)
*Toronto – urltoken Hashtag Arabia (hashtag , Arabic, English)
*Toronto – urltoken Al-Mersal, Al Muhajer (The Migrant, Arabic, English, French)
*Ottawa – Arab Canada Newspaper (Arabic)
*Vancouver – urltoken Muslim Community Journal
*Willowdale, Ontario – urltoken Al-Ahram Elgdeed
===Armenian===
* Montreal – Abaka (Armenian, French, English), Horizon Weekly (Armenian, French, English)
===Bengali===
*Montreal – International Dhaka Post (Bengali, English)
* Toronto – urltoken The Bangla Kagoj, urltoken Bengali Time, The Deshe Bideshe (Bengali, English), urltoken Notundesh Canada
===Bulgarian===
* Montreal – Forum Bulgare 
===Caribbean===
* Toronto – The GTA Times, The GTA Times Inc., urltoken Toronto Caribbean Newspaper, Vision Newspaper Canada
* Montreal – Montreal Community Contact
===Chinese===
* Calgary – urltoken Canadian Chinese Times (Chinese: 加华报), Sing Tao Daily
*Edmonton – urltoken Edmonton Chinese News (Chinese: 愛華報), Sing Tao Daily
* Hamilton, Ontario – urltoken Hamilton Chinese News 
* London, Ontario – urltoken London Chinese Post 
* Mississauga, Ontario – urltoken Mississauga Chinese News 
* Montreal – The Chinese News (Chinese: 华侨新报), Luby Chinese Weekly (Chinese: 路比華訊), urltoken Sept Days (Chinese: 七天), urltoken Sino Quebec , urltoken Today Commercial News 
* Ottawa, Ontario – Capital Chinese News, Canada Chinese News, The Ottawa Weekend 
* Toronto – urltoken Canada China News; Chinese: 中华导报), Ming Pao Daily News , Sing Tao Daily , Today Daily News 
* Vancouver – Asian Pacific Post, urltoken Dawa Business Press (Chinese: 大华商报), urltoken Global Chinese Press (Chinese: 环球华报), urltoken Health Times (Chinese: 健康时报), Sing Tao Daily, Ming Pao Daily News, urltoken Voice Richmond Weekly
* Winnipeg – Manitoba China Times , urltoken Winnipeg Chinese Post (Chinese: 温尼伯华商报)
===Dutch===
* Oakville, Ontario – De Krant
===Farsi===
* Montreal – Hafteh (Persian هفته), Payvand (Persian پیوند)
* Toronto – urltoken Atash (Persian آتش)
=== Filipino ===
* Montreal – urltoken Filipino Star
* Toronto – urltoken Daily South Asian Free Press, urltoken Diaryo Alberta, urltoken Filipiniana, Philippine Reporter, urltoken South Asian Star
* Vancouver – The Filipino Post, Philippine Asian Chronicles, urltoken Philippine Canadian Inquirer
* Winnipeg – Ang Peryodiko, The Filipino Journal, The Philippine Times
===Finnish===
* Thunder Bay, Ontario – Canadan Sanomat
*Toronto – Canadan Uutiset, urltoken Kanadan Sanomat
*Vancouver – urltoken Länsirannikon Uutiset
===German===
* Calgary – urltoken Mill Woods Mosaic
* Edmonton – urltoken The Albertaner
* Montreal – Das Echo
* Ottawa – urltoken The Hofbräuhaus News
* Steinbach, Manitoba – Das Blatt, Die Mennonitische Post
*Toronto – urltoken Das Journal, Deutsche Presse, Deutsche Rundschau, urltoken Echo Germanica, urltoken Neue Welt
===Greek===
* Montreal – Ta Ellinikacanadika Nea , The Montreal Greek Times, Vima (Greek, English, French), The Greek Press 
* Toronto – urltoken Balita, urltoken he Greek Press (Greek: Ελληνικός Τύπος)
* Vancouver – Gnome 
=== Gujarati ===
* Toronto – urltoken Gujarat Abroad, urltoken Gujarat Newsline, urltoken Gujarat Weekly, urltoken Swadesh
===Hebrew/Jewish===
* Montreal – The Moment
* Ottawa – Ottawa Jewish Bulletin (Hebrew, English)
* Toronto – Shalom Toronto
===Hindi===
* Montreal – urltoken Bharat Times
* Toronto – urltoken Asian Connections, urltoken Asian Tribune, Ask Me Biz, Can-India News, urltoken Canadian Asian News, urltoken Delhi News Record, urltoken Diversity Reporter, urltoken Hindi Abroad, India Calling, Indian Express Canada, Journal India, urltoken The South Asian News, urltoken South Asian Weekender, urltoken Weekly Voice
* Vancouver – urltoken Apna Roots, urltoken Asian Journal, urltoken Asian Pacific Post, urltoken The Asian Star, urltoken Hindi Journal, urltoken The Indo-Canadian Voice, urltoken The Link, urltoken The South Asian Post
===Icelandic===
* Winnipeg – Lögberg-Heimskringla
===Italian===
* Montreal – Corriere Italiano, Il Cittadino Canadese
* Ottawa – Il Postino, L'Ora di Ottawa
* Toronto – Corriere Canadese
===Japanese===
* Vancouver – urltoken Vancouver Shinpo (discontinued since April 30, 2020.)<ref> urltoken 
* Toronto – urltoken Nikka Times, urltoken Nikkei Voice
===Korean===
* Toronto – The Korea Times Daily 
* Vancouver – urltoken Canada Express Korean, urltoken Vanchosun.
=== Nepali ===
* Toronto – urltoken Canada Nepal
=== Polish ===
*Vancouver – Takie Życie
===Portuguese===
* Montreal – A Voz de Portugal, urltoken Lusopresse
* Toronto – urltoken ABC Portuguese Canadian, Além-Fronteiras, urltoken Milénio Stadium, urltoken North News, Nove Ilhas, Portuguese Post, urltoken Sol Português, urltoken Voice Portuguese-Canadian Newspaper
* Winnipeg – O Mundial
===Punjabi===
*Edmonton – urltoken Nawi Dunia
* Calgary – Des Punjab Times (Punjabi and English)
*Toronto – urltoken Ajit Weekly, urltoken Canadian Punjabi Post (Punjabi), urltoken Khabarnama Punjabi Weekly, urltoken Punjab Star, urltoken Punjabi Awaaz
*Montreal – urltoken Desi Times (Punjabi and English)
*Vancouver – urltoken Akai Guardian, Canadian Punjab Times (Punjabi), urltoken Charhdi Kala, urltoken Indo-Canadian Times, urltoken The Patrika, urltoken Punjab Di Awaaz, urltoken Punjabi Journal
===Romanian===
* Hamilton, Ontario – Agenda Romaneasca
* Montreal – Accent Montreal, Pagini Romanesti , Zig-Zag Roman-Canadian
* Toronto – Acasa, Faptu' Divers
===Russian===
* Toronto – urltoken Nasha Canada - Наша Канада
* Montreal – Monrealskaya Gazeta Zapad-Vostok , Nasha Gazeta Montreal , The Voice of Community, (Russian: ГОЛОС ОБЩИНЫ)
=== Sinhala ===
* Toronto – Sri Lankan Anchorman, urltoken The Sri Lanka Reporter
===Spanish===
*Calgary – urltoken Canadian Latino Newspaper
* Hamilton, Ontario – urltoken Presencia Latina
* Montreal – urltoken L'Alternativa Latina, urltoken El Chasqui Latino, urltoken El Directorio Comercial Latino de Montreal, urltoken Journal Comercio Latino, urltoken Nueva Prensa Libre, urltoken Noticias Montreal
* Ottawa – Ecolatino
*Toronto – urltoken Correo Canadiense, urltoken El Popular, urltoken La Jornada, La Portada Canadá, La Voz Latina, urltoken El Centro News, urltoken Toronto Dominicano
* Vancouver – La Re – Vista
=== Swedish ===
* Vancouver – urltoken Nya Svenska Presse
=== Tamil ===
* Toronto – urltoken Amalai Express, urltoken Canada Uthayan, urltoken Dasatha, Free Voice Media Creations, urltoken Thangatheepam News, urltoken The Times of Sri Lanka
===Turkish===
* Montreal – urltoken Bizim Anadolu (Turkish, English, French)
* Toronto – urltoken Canadatürk (Turkish, English)
===Ukrainian===
* Toronto – New Pathway: Ukrainian Weekly Newspaper (Ukrainian: Новий Шлях: Український Тижневик)
* Winnipeg – The Ukrainian Voice (Ukrainian: Український Голос)
=== Urdu ===
* Calgary – urltoken The Canadian Times, urltoken Weekly Canada Express
* Montreal – urltoken Nawai Pakistan
* Toronto – urltoken Eastern News, urltoken Sunday Times, urltoken Urdu Post Canada
* Vancouver – urltoken Urdu Journal
===Vietnamese===
*Calgary – urltoken Việt Nam Thời Báo
* Montreal – urltoken Tuần Tin Montréal, Việt Báo
* Toronto – urltoken Thời Báo
* Vancouver – Thoi Su, urltoken Tự Do
==Religious newspapers==
* Edmonton, Alberta – Living Light News (Christian)
==Monthly newspapers==
* L'Action nationale
* L'aut'journal
* urltoken L'initiative
* Cult MTL
* Electric City Magazine – Peterborough, Ontario
* urltoken The Dawson Trail Dispatch - SE Manitoba
* The Hudson Bay Post – Churchill, Manitoba
* People's Voice
* Le Québécois
* Scene
* Windsor Independent
==Student newspapers==
===Alberta===
* Athabasca University – The Voice Magazine
* Lethbridge College – The Endeavour
* MacEwan University – The Griff
* Mount Royal University – The Reflector
* Northern Alberta Institute of Technology – The Nugget
* Southern Alberta Institute of Technology – The Weal, Polytechnic Press
* University of Alberta – The Gatewa, The Dagligtale
* University of Calgary – The Gauntlet
* University of Lethbridge – The Meliorist
===British Columbia===
* British Columbia Institute of Technology – The Link
* Camosun College – The Nexus
* Capilano University – The Capilano Courier
* Douglas College – The Other Press
* Emily Carr University of Art and Design – Woo Magazine
* Kwantlen Polytechnic University – The Runner
* Langara College – The Voice
* Quest University – The Spit
* Selkirk College – The Sentinel
* Simon Fraser University – The Peak
* Thompson Rivers University – The Omega
* Trinity Western University – Mars' Hill
* University of British Columbia – The Ubyssey
* University of British Columbia Okanagan – The Phoenix
* University of the Fraser Valley – The Cascade
* University of Northern British Columbia – Over the Edge
* University of Victoria – The Martlet
* Vancouver Island University – The Navigator
===Manitoba===
* Brandon University – The Quill
* Canadian Mennonite University – The Doxa
* Red River College – The Projector
* St. Paul's College – The Paulinian
* Université de Saint-Boniface – Le Réveil
* University of Manitoba – The Manitoban
* University of Winnipeg – The Uniter
===New Brunswick===
* Mount Allison University – The Argosy
* St. Thomas University – The Aquinian
* Université de Moncton – Le Front
* University of New Brunswick – The Brunswickan (Fredericton campus), The Baron (Saint John campus)
===Newfoundland and Labrador===
* Memorial University of Newfoundland – The Muse
===Nova Scotia===
* Acadia University – The Athenaeum
* Cape Breton University – The Caper Times
* Dalhousie University – The Dalhousie Gazette
* Mount Saint Vincent University – The Sentinel
* Nova Scotia Agricultural College – Golden Ram
* Saint Francis Xavier University – The Xaverian Weekly
* Saint Mary's University – The Journal
* University of King's College – The Watch
===Ontario===
* Algoma University – The Sentient
* Algonquin College – Algonquin Times
* Brock University – The Brock Press
* Carleton University – The Charlatan
* Centennial College – The Centennial College Courier
* Conestoga College – The Spoke
* Durham College – The Chronicle
* Fanshawe College – The Interrobang
* George Brown College – The Dialog
* Humber College – Humber Etcetera
* Lakehead University – The Argus
* Laurentian University – Lambda (English), L'Orignal déchaîné (French)
* Loyalist College – The Pioneer
* McMaster University – The Silhouette
* Mohawk College – Ignite News
* Niagara College – Niagara News
* Nipissing University – Student Spotlight, Campus Free Press
* OCAD University – Cadmium
* Queen's University at Kingston – The Queen's Journal, Golden Words
* Redeemer University College – The Crown
* Royal Military College of Canada – The Precision
* Ryerson University – The Eyeopener, The Ryersonian
* St. Clair College – The Saint
* Seneca College – The Buzz
* Sheridan College – Sheridan Sun
* Trent University – Arthur,The Absynthe
* University of Guelph – The Ontarion
* University of Ontario Institute of Technology – Chronicle
* University of Ottawa – Fulcrum (English), La Rotonde (French)
* University of Toronto – The Newspaper, The Varsity
**Innis College – Innis Herald
** St. Michael's College – The Mike
** Trinity College – Salterrae
** University College – The Gargoyle
** Victoria University – The Strand
* University of Toronto Mississauga – The Medium
* University of Toronto Scarborough – The Underground
* University of Waterloo – Imprint
* University of Western Ontario – UWO Gazette
* University of Windsor – The Lance
* Wilfrid Laurier University – The Cord, The Sputnik
* York University – Excalibur
** Glendon College – Pro Tem
** McLaughlin College – MacMedia
** Osgoode Hall – Obiter Dicta
===Prince Edward Island===
* Holland College – The Surveyor
* University of Prince Edward Island – The Cadre
===Quebec===
* Bishop's University – The Campus
* Cégep de Jonquière – La Pige<ref></ref>
* Cégep du Vieux Montréal – Le Bagou, L'ultimatum, Le p'tit vieux
* Cégep régional de Lanaudière (Joliette campus) – Le Détour
* Concordia University – The Link (English), The Concordian (English), L'Organe (French)
* Dawson College – The Plant
* École Polytechnique de Montréal – Le Polyscope
* HEC Montréal – L’intérêt
* John Abbott College – Bandersnatch
* McGill University – The McGill Daily, McGill Tribune, The Bull & Bear, Le Délit français (French)
* MRC des Laurentides – Mainstreet
* Téluq – Sans Papier
* Université de Montréal – Quartier Libre, Forum
* Université de Sherbrooke – Le Collectif
* Université du Québec à Chicoutimi – Le Griffonnier
* Université du Québec à Montréal – Montréal Campus
* Université du Québec à Trois-Rivières – Entête
* Université Laval – Impact Campus, La Marmite sociale, Le Fil des évènements
===Saskatchewan===
* University of Regina – The Carillon
* University of Saskatchewan – The Sheaf
==See also==
* History of Canadian newspapers
* List of editors-in-chief of the largest newspapers in Canada
* List of Indigenous periodicals in Canada
* List of newspapers in Canada by circulation
* List of student newspapers in Canada
* List of defunct newspapers of Canada
* Media in Toronto
==References==
==External links==
* urltoken Canadian Newspaper List
* urltoken Canada Newspapers
* urltoken Canadian Newspaper Association

This list of newspapers in Canada is a list of newspapers printed and distributed in Canada.